110 1 M 1 0
111 2 M 2 0
112 3 M 3 0
113 x M 4 0
220 1 M 1 0
221 2 M 2 0
222 3 M 3 0
223 x M 4 0
330 1 M 1 1
331 2 M 2 0
332 3 M 3 0
333 x M 4 0
110 1 F 1 0
111 2 F 2 0
112 3 F 3 0
113 x F 4 0
220 1 F 1 0
221 2 F 2 0
222 3 F 3 0
223 x F 4 0
330 1 F 1 0
331 2 F 2 0
332 3 F 3 0
333 x F 4 0
333 x F 4 0
